0 0 0 0 0 0 0 0 0 0 0 0 0 0 0 0 0 0 0 0 0 0 0 0 0 0 0 0 0 0 0 0 0 0
11 1 1 11 7 8 11 11 11 11 11 11 11 11 7 8 11 11 11 11 11 11 11 11 11 11 11 11 11 11 11 11 11 11
11 1 1 11 9 10 1 1 1 1 1 1 1 1 9 10 1 1 1 1 1 1 1 1 1 1 1 1 1 1 1 1 1 11
11 1 1 11 7 8 1 1 1 1 1 1 1 1 7 8 1 1 1 1 1 1 1 1 1 1 1 1 1 1 1 1 1 11
11 1 1 11 9 10 1 1 1 1 1 1 1 1 9 10 1 1 1 1 11 11 11 11 11 11 11 11 11 11 1 1 1 11
11 1 1 11 7 8 1 1 1 11 11 1 1 1 7 8 2 2 2 11 7 8 7 8 7 8 7 8 7 8 11 1 1 11
11 1 1 11 9 10 1 1 1 11 11 1 1 1 9 10 4 2 2 11 9 10 9 10 9 10 9 10 9 10 11 1 1 11
11 4 3 11 7 8 2 5 4 11 11 2 4 5 7 8 2 2 2 11 7 8 7 8 7 8 7 8 7 8 11 1 1 11
11 3 3 11 9 10 6 2 5 11 11 3 4 2 9 10 2 3 4 11 9 10 9 10 9 10 9 10 9 10 11 1 1 11
11 3 2 11 7 8 2 3 4 11 11 2 2 4 7 8 2 2 2 2 2 2 2 3 1 1 1 1 1 1 1 1 1 11
11 3 3 11 9 10 2 2 2 11 11 5 2 2 9 10 2 6 3 2 3 2 2 5 1 1 1 1 1 1 1 1 1 11
11 2 3 11 7 8 2 6 2 11 11 2 2 2 7 8 2 2 2 11 7 8 7 8 11 1 1 11 7 8 2 2 4 11
11 6 3 11 9 10 2 5 2 11 11 3 2 4 9 10 2 4 2 11 9 10 9 10 11 1 1 11 9 10 2 5 2 11
11 3 3 11 7 8 2 2 2 11 11 2 2 2 7 8 2 2 6 11 7 8 7 8 11 1 1 11 7 8 2 2 2 11
11 3 3 11 9 10 2 3 2 11 11 2 2 4 9 10 2 2 2 11 9 10 9 10 11 1 1 11 9 10 2 2 3 11
11 3 3 11 7 8 2 3 6 11 11 5 2 2 7 8 2 2 3 11 7 8 7 8 11 1 1 11 7 8 2 2 2 11
11 5 3 11 9 10 2 5 6 11 11 2 2 2 9 10 2 2 2 11 9 10 9 10 11 1 1 11 9 10 2 5 4 11
11 4 3 11 7 8 2 3 2 11 11 2 2 2 1 1 2 2 3 11 7 8 7 8 11 1 1 11 7 8 2 2 2 11
11 3 3 11 9 10 2 3 5 11 11 2 2 3 1 1 2 2 2 11 9 10 9 10 11 1 1 11 9 10 2 5 3 11
11 3 3 11 7 8 2 2 5 11 11 1 1 1 1 1 1 1 1 11 7 8 7 8 11 1 1 1 1 1 1 1 1 11
11 3 2 11 9 10 2 2 5 11 11 1 1 1 1 1 1 1 1 11 9 10 9 10 11 1 1 1 1 1 1 1 1 11
11 3 2 11 7 8 2 2 6 11 7 8 7 8 7 8 7 8 7 8 7 8 7 8 11 2 2 2 7 8 11 1 1 11
11 3 4 11 9 10 2 2 4 11 9 10 9 10 9 10 9 10 9 10 9 10 9 10 11 2 2 2 9 10 11 1 1 11
11 2 2 4 1 1 2 2 2 11 7 8 7 8 7 8 7 8 7 8 7 8 7 8 11 2 2 2 7 8 11 1 1 11
11 3 2 2 1 1 2 2 6 11 9 10 9 10 9 10 9 10 9 10 9 10 9 10 11 2 2 2 9 10 11 1 1 11
11 1 1 1 1 1 1 1 1 1 1 1 1 11 7 8 7 8 7 8 7 8 7 8 11 3 3 3 7 8 11 1 1 11
11 1 1 1 1 1 1 1 1 1 1 1 1 11 9 10 9 10 9 10 9 10 9 10 11 2 2 2 9 10 11 1 1 11
7 8 7 8 7 8 7 8 7 8 11 1 1 11 7 8 7 8 7 8 7 8 7 8 11 2 2 2 7 8 11 1 1 11
9 10 9 10 9 10 9 10 9 10 11 1 1 11 9 10 9 10 9 10 9 10 9 10 11 2 2 2 9 10 11 1 1 11
7 8 7 8 7 8 7 8 7 8 11 1 1 11 7 8 7 8 7 8 7 8 7 8 11 2 2 2 7 8 11 1 1 11
9 10 9 10 9 10 9 10 9 10 11 1 1 11 9 10 9 10 9 10 9 10 9 10 11 2 2 2 9 10 11 1 1 11
11 6 2 3 2 2 2 5 6 11 7 8 7 8 7 8 7 8 7 8 7 8 7 8 11 2 2 2 7 8 11 1 1 11
11 2 2 5 4 2 4 5 2 11 9 10 9 10 9 10 9 10 9 10 9 10 9 10 11 2 2 2 9 10 11 1 1 11
7 8 7 8 7 8 1 1 2 2 3 6 2 4 2 2 1 1 3 11 7 8 7 8 11 2 1 1 1 1 1 1 1 11
9 10 9 10 9 10 1 1 2 2 2 2 5 6 2 3 1 1 2 11 9 10 9 10 11 3 1 1 1 1 1 1 1 11
7 8 7 8 7 8 1 1 2 11 7 8 7 8 11 2 1 1 6 11 7 8 7 8 11 2 1 1 7 8 7 8 7 8
9 10 9 10 9 10 1 1 2 11 9 10 9 10 11 6 1 1 2 11 9 10 9 10 11 5 1 1 9 10 9 10 9 10
7 8 7 8 7 8 1 1 2 11 7 8 7 8 11 4 1 1 2 11 7 8 7 8 11 2 1 1 7 8 7 8 7 8
9 10 9 10 9 10 1 1 2 11 9 10 9 10 11 3 1 1 4 11 9 10 9 10 11 6 1 1 9 10 9 10 9 10
7 8 7 8 7 8 1 1 3 11 7 8 7 8 11 4 1 1 5 11 7 8 7 8 11 2 1 1 7 8 7 8 7 8
9 10 9 10 9 10 1 1 2 11 9 10 9 10 11 2 1 1 2 11 9 10 9 10 11 2 1 1 9 10 9 10 9 10
11 2 2 3 2 2 1 1 2 2 2 2 2 2 2 2 1 1 2 2 2 2 2 2 2 2 1 1 6 2 2 2 2 11
11 2 2 2 2 2 1 1 2 2 2 2 2 2 2 2 7 8 2 2 2 2 2 2 2 2 1 1 2 2 4 2 6 11
11 2 2 2 2 4 1 1 1 1 1 1 1 1 1 1 9 10 1 1 1 1 1 1 1 1 1 1 2 2 2 2 6 11
11 2 5 2 2 2 1 1 1 1 1 1 1 1 1 1 1 1 1 1 1 1 1 1 1 1 1 1 4 3 2 2 2 11
7 8 7 8 7 8 7 8 7 8 7 8 7 8 11 1 1 1 1 11 7 8 7 8 7 8 7 8 7 8 7 8 7 8
9 10 9 10 9 10 9 10 9 10 9 10 9 10 11 1 1 1 1 11 9 10 9 10 9 10 9 10 9 10 9 10 9 10
7 8 7 8 7 8 7 8 7 8 7 8 7 8 11 1 1 1 1 11 7 8 7 8 7 8 7 8 7 8 7 8 7 8
9 10 9 10 9 10 9 10 9 10 9 10 9 10 11 1 1 1 1 11 9 10 9 10 9 10 9 10 9 10 9 10 9 10
0 0 0 0 0 0 0 0 0 0 0 0 0 0 0 0 0 0 0 0 0 0 0 0 0 0 0 0 0 0 0 0 0 0
